0;0;0;0;0;0;0;0;0;1;1;1;1;2;2;1;1;1;1;0;0;0;0;0;0;0;0;0;0;0;3;3;3;3;3;3;0;0;0;3;3;3;3;3;3;3;0;0;0;0;50
0;0;0;0;0;0;0;0;1;1;1;1;2;2;2;1;1;1;0;0;0;0;0;0;0;0;0;0;0;0;0;3;3;3;3;0;0;0;0;0;3;3;3;3;3;0;0;0;0;0;
0;0;0;0;0;0;1;1;1;1;1;2;2;1;1;1;0;0;0;0;0;0;0;0;0;0;0;0;0;0;0;0;3;3;0;0;0;0;0;0;0;0;0;0;0;0;0;3;3;3;
0;0;0;0;0;1;1;1;1;1;2;2;1;1;1;1;0;5;0;0;0;1;1;1;1;0;0;0;0;0;0;0;0;0;0;0;0;0;0;0;0;0;0;0;0;0;3;3;3;3;
0;0;0;0;1;1;1;1;4;1;2;2;1;1;1;0;0;0;0;1;1;1;1;1;1;1;0;0;0;0;0;0;5;0;0;0;0;0;0;0;0;0;0;5;0;3;3;3;3;3;
0;0;0;1;1;1;1;1;1;1;2;2;1;1;1;0;1;1;0;1;1;1;1;4;1;1;1;1;0;0;0;0;0;0;0;0;0;0;3;3;3;3;0;0;0;3;3;3;3;3;
0;0;0;1;1;1;1;1;1;2;2;1;1;4;1;1;1;1;1;1;1;1;1;1;1;1;1;1;1;0;0;0;0;0;0;0;0;0;3;3;3;3;3;3;3;3;3;3;3;3;
0;0;0;1;1;1;1;1;1;2;2;1;1;1;1;1;4;1;1;1;2;2;2;1;1;1;1;1;1;1;0;0;0;0;0;0;3;3;3;3;3;3;3;3;3;3;3;3;3;3;
0;0;0;0;1;1;1;1;1;2;2;1;1;1;2;2;1;1;1;2;2;2;2;2;2;1;1;1;1;1;0;1;4;0;0;0;3;3;3;3;3;3;3;3;3;3;3;3;3;3;
0;0;0;0;0;1;1;1;1;2;2;2;2;2;2;2;2;1;2;2;2;2;2;2;2;2;1;1;1;1;1;1;0;0;0;3;3;3;3;3;3;3;3;3;3;3;3;3;0;0;
0;0;0;0;0;0;1;1;1;1;2;2;2;2;2;2;2;2;2;2;2;2;2;2;2;2;2;1;1;1;1;0;0;0;0;3;3;3;3;3;3;3;3;3;3;3;0;0;0;5;
0;0;0;0;0;0;0;1;1;1;1;1;1;1;1;2;2;2;2;2;2;2;2;2;2;2;2;1;1;1;1;1;1;0;0;0;3;3;3;3;3;3;3;3;0;0;0;0;0;0;
0;0;5;0;0;0;0;0;1;1;1;1;4;1;2;2;2;2;2;2;2;2;2;2;2;2;2;1;1;1;1;1;1;1;0;0;0;3;3;3;3;3;3;3;0;0;0;0;0;0;
0;0;0;0;0;0;0;1;1;1;1;1;1;1;2;2;2;2;2;2;2;2;2;2;2;2;1;1;1;1;1;1;4;1;0;0;0;0;0;3;3;3;0;0;0;0;0;0;0;0;
0;0;0;0;0;0;0;1;1;1;1;1;1;2;2;2;2;2;2;2;2;2;2;2;2;2;1;1;1;1;1;1;1;1;0;0;0;0;0;0;0;0;0;0;5;0;0;0;0;0;
0;0;0;0;0;0;1;1;1;1;1;1;1;2;2;2;2;2;2;2;2;2;2;2;2;2;1;4;1;1;1;1;1;1;1;1;4;0;0;0;0;0;0;0;0;0;0;0;0;0;
0;0;0;0;0;1;1;1;1;1;1;1;2;2;2;2;2;2;2;2;2;2;2;2;2;2;2;1;1;1;1;1;1;1;1;1;1;0;0;0;0;0;0;0;0;0;0;0;0;0;
0;0;0;0;0;1;1;1;1;1;1;2;2;2;2;2;2;2;2;2;2;2;2;2;2;2;2;1;1;1;1;1;1;1;1;1;1;0;0;0;0;0;0;0;0;0;0;0;0;0;
0;5;0;0;1;1;1;1;1;1;1;2;2;2;2;2;2;2;2;2;2;2;2;2;2;2;2;1;1;1;1;1;1;1;1;1;1;1;1;0;0;0;0;0;0;0;0;0;0;0;
0;0;0;1;1;1;1;1;1;1;1;1;2;2;2;2;2;2;2;2;2;2;2;2;2;2;1;1;1;1;1;1;1;1;1;1;1;1;1;1;0;0;0;1;1;0;0;0;5;0;
0;0;0;1;1;1;1;1;1;1;1;1;1;1;2;2;2;2;2;2;2;2;2;2;2;2;1;1;4;1;1;2;2;2;1;1;1;1;1;1;1;1;1;1;1;1;0;0;0;0;
0;0;1;1;1;1;1;1;1;1;1;1;1;1;1;2;2;2;2;2;2;2;2;2;2;1;1;1;1;1;1;1;2;2;2;1;1;1;1;1;1;1;1;4;1;1;0;0;0;0;
0;1;1;1;1;1;1;1;1;1;1;1;1;4;1;1;1;2;2;2;2;2;2;2;1;1;1;1;1;1;1;2;2;2;2;1;1;1;1;1;1;1;1;1;1;0;0;0;0;0;
0;1;4;1;1;1;1;1;1;1;1;1;1;1;1;1;1;1;2;2;2;2;2;1;1;1;1;1;1;2;2;2;2;2;2;2;1;1;1;1;1;1;1;1;1;0;0;0;0;3;
0;0;1;1;1;1;1;1;1;1;1;1;1;1;1;1;1;2;2;2;2;2;1;1;1;1;1;1;2;2;2;2;2;2;2;2;1;1;1;1;1;1;1;1;0;0;0;0;0;3;
0;0;1;1;1;1;1;1;1;1;1;1;1;1;1;1;2;2;2;2;2;2;1;1;1;1;1;2;2;2;2;2;2;2;2;2;2;1;1;1;1;1;1;0;0;0;3;3;3;3;
0;0;0;0;1;1;1;1;4;1;1;1;1;1;1;1;2;2;2;2;2;1;1;1;1;1;2;2;2;2;2;2;2;2;2;2;2;2;1;1;1;1;0;0;0;3;3;3;3;3;
0;0;0;0;0;0;0;0;1;1;1;1;1;1;1;1;1;2;2;2;1;1;1;4;1;1;1;1;2;2;2;2;2;2;2;2;2;2;2;1;1;1;0;0;3;3;3;3;3;3;
0;0;0;0;0;3;3;0;0;1;1;1;1;1;1;1;1;1;1;1;1;1;1;1;1;1;1;1;1;1;2;2;2;2;2;2;2;2;2;1;1;1;0;0;3;3;3;3;3;3;
0;0;0;0;3;3;3;3;0;0;0;1;1;1;1;1;1;1;1;1;1;1;1;1;1;1;1;1;1;1;1;1;1;2;2;2;2;2;1;1;1;1;0;0;0;3;3;3;3;3;
0;0;0;3;3;3;3;3;3;0;0;0;1;1;1;0;0;0;0;1;1;1;1;1;1;1;1;0;0;0;0;0;1;1;2;2;2;1;1;1;1;1;0;0;0;0;3;3;3;3;
0;0;3;3;3;2;2;2;3;3;3;0;1;1;0;0;3;3;3;0;1;1;1;1;1;0;0;0;0;3;3;0;0;1;1;2;2;2;1;1;1;1;1;4;0;0;0;3;3;3;
0;0;3;3;3;2;2;2;3;3;0;0;0;0;0;3;3;3;3;0;1;1;1;1;0;0;0;0;3;3;3;3;0;0;1;1;2;2;1;1;1;1;1;1;1;0;0;0;0;3;
0;0;0;3;3;2;2;2;3;3;0;0;0;0;0;0;3;3;0;0;1;1;1;0;0;0;0;3;3;3;3;3;3;0;1;1;2;2;1;1;1;1;1;1;1;1;1;0;0;0;
0;0;0;0;3;3;3;3;3;0;0;0;5;0;0;0;3;0;0;1;1;1;0;0;0;0;3;3;3;3;3;3;3;0;1;2;2;1;1;1;1;1;1;1;1;1;1;1;0;0;
0;0;0;0;0;3;3;3;3;0;0;0;0;0;3;3;3;0;1;1;1;0;0;0;5;0;0;3;3;3;3;3;0;1;1;2;2;1;1;1;1;1;1;1;1;1;1;1;0;0;
0;0;0;0;0;0;3;3;0;0;0;0;0;0;3;3;3;0;1;1;1;0;0;0;0;0;0;0;0;3;3;0;0;1;1;2;2;1;1;1;1;1;1;1;1;1;4;1;1;0;
0;0;0;0;0;5;0;3;0;0;0;0;0;0;0;3;3;0;1;1;1;1;1;0;0;0;0;0;0;0;0;0;1;1;2;2;2;1;1;1;1;1;1;1;1;1;1;1;1;0;
0;0;0;0;0;0;0;3;0;0;0;0;0;0;3;3;3;0;0;1;1;1;1;1;0;0;1;1;1;1;1;1;1;1;2;2;1;1;1;1;1;1;1;1;1;1;1;1;1;0;
0;0;0;0;0;3;3;3;0;0;0;0;1;0;3;3;3;3;0;0;1;1;1;1;1;1;1;1;1;1;1;1;1;1;1;2;1;1;1;1;1;1;1;1;1;1;1;1;1;0;
0;0;0;0;3;3;3;3;3;0;0;0;1;0;0;0;0;0;0;5;1;1;1;1;1;1;1;1;1;1;1;1;4;1;1;2;2;1;1;1;1;1;1;1;1;1;1;1;1;0;
0;0;0;3;3;3;3;3;3;3;0;0;4;1;0;0;0;0;1;1;1;1;1;1;1;1;1;2;2;1;1;1;1;1;1;2;2;1;1;1;1;1;1;1;1;1;1;1;1;0;
0;0;0;3;3;3;3;3;3;3;0;0;0;1;1;1;1;1;1;1;1;1;1;1;1;1;2;2;2;2;1;1;1;1;2;2;2;1;1;1;1;1;1;1;1;1;1;1;1;0;
0;0;0;0;3;3;3;3;3;0;0;0;0;1;1;1;1;1;1;1;1;1;1;2;2;2;2;1;1;2;2;2;2;2;2;2;1;1;0;0;1;1;1;1;1;1;1;1;1;0;
0;0;0;0;0;3;3;3;0;0;0;1;1;1;1;1;1;1;2;2;2;1;1;2;2;1;1;1;1;1;1;2;2;2;2;1;1;1;0;0;0;0;1;1;1;1;1;1;0;0;
0;0;0;0;0;0;3;0;0;0;1;1;1;1;1;1;1;2;2;2;2;2;4;2;2;1;1;4;1;1;1;1;1;1;1;1;4;0;0;0;0;0;0;1;1;1;0;0;0;0;
0;5;0;0;0;0;0;0;0;4;1;1;1;1;1;2;2;2;1;1;2;2;2;2;1;1;1;1;0;0;0;0;0;0;1;0;0;0;0;0;0;0;0;4;1;0;0;0;0;0;
0;0;0;0;0;0;0;0;1;1;1;1;1;2;2;2;1;1;1;1;1;1;2;2;1;1;0;0;0;0;0;0;0;0;0;0;0;0;0;0;0;0;0;0;0;0;0;0;0;0;
0;0;0;0;0;0;1;1;1;1;1;1;1;2;2;1;1;1;1;1;1;1;1;1;1;0;0;0;0;3;3;3;3;0;0;0;0;0;0;3;0;0;0;0;0;0;0;0;0;0;
0;0;0;0;0;1;1;1;1;1;1;1;4;2;2;1;1;1;1;1;1;1;1;1;0;0;0;0;3;3;3;3;3;3;3;3;3;3;3;3;3;0;0;0;0;0;0;0;0;0;
